1 21
WWWWWWWW
WP W G W
W  W   W
WS2W M W
W    $ W
WF $   W
WWWWWWWW
