1 9
WWWWWWWW
WPS    W
WWWW 3 W
W $    W
W  M   W
W     GW
WWWWWWWW
